..........
....CC....
...ADDA...
..ADBBDA..
...AAAA...
....DD....
..........
..........
..........
..........
